# Ukrainian multiwords file used for chunking
# FR  frazeologism
#
до мажор	noun:m:nv
до минор	noun:m:nv
н. е.	noun
Пальма де Мальорка	noun:f:nv
да Вінчі	noun:m:nv
КП(б)У	noun:f:nv
#
до упаду	adv
до впаду	adv
для годиться	adv
задля годиться	adv
значною мірою	adv
повною мірою	adv
тією мірою	adv
за дякую	adv
на дурняк	adv
без перестанку	adv
де можна	adv
де тільки можна	adv
поміж люди	adv
з давніх-давен	adv
таким чином	adv
головним чином	adv
справедливості заради	adv
Справедливості заради	adv
Об'єктивності заради	adv
об'єктивності заради	adv
на галай-балай	adv
за спасибі	adv

правду кажучи	insert
без сумніву	insert
певна річ	insert
дивна річ	insert
на щастя	insert
на диво	insert
слава Богу	insert
на жаль	insert
як на зло	insert
на сором	insert
чого доброго	insert
як навмисне	insert
як на біду	insert
як кажуть	insert
на мою думку	insert
як відомо	insert
#на думку ...	insert
#за словами ...	insert
до речі	insert
між іншим	insert
крім того	insert
інакше кажучи	insert
таким чином	insert
уяви собі	insert
зверніть увагу	insert
майте на увазі	insert
між нами кажучи	insert
може бути	insert
